5
_ _ _ R _
_ _ _ _ _
_ _ F _ _
_ _ _ _ _
_ R _ _ _