25
_________________________
_GGGGGC__________________
_GGGGGC___GGGGGG_________
_GGGGGC___CCCCCC_________
_GGGGGC___GGGGGG_________
_________________________
_________________________
_____CGGGGGGGGGGGGGG_____
_____CGGGGGGGGGGGGGG_____
_____CGGGGGGGGGGGGGG_____
_____CGGGGGGGGGGGGGG_____
_____CGGGGGGGGGGGGGG_____
__GGGGGGGGGGGGGGCCCCCCCC_
__GGGGGGGGGGGGGGCCCCCCCC_
__GGGGGGGGGGGGGGCCCCCCCC_
__GGGGGGGGGGGGGGCCCCCCCC_
__GGGGGGGGGGGGGGCCCCCCCC_
_________________________
_______GGGGGGGGGGGGGGGG__
_______GGGGGGGGGGGGGGGG__
_______GGGGGGGGGGGGGGGG__
_______GGGGGGGGGGGGGGGG__
_______GGGGGGGGGGGGGGGG__
_______GGGGGGGGGGGGGGGG__
_________________________
