30
GGGG__GGCGG__GGCGGGGGCGG__GCGG
GGCC__GGCGG__GGCGGGGGCGG__GCGG
GGCC__GGCGG__GGCGGGGGCGG__GCGG
GGGG__GGCGG__GGCGGGGGCGG__GCGG
GGGG__GGCGG__GGCGGGGGCGG__GCGG
GGGG__GGCGG__GGCGGGGGCGG__GCGG
GGGG__GGCGG__GGCGGGGGCGG__GCGG
GGGG__GGCGG__GGCGGGGGCGG__GCGG
GGGG__GGCGG__GGCGGGGGCGG__GCGG
GGGG__GGCGG__GGCGGGGGCGG__GCGG
GGGG__GGCGG__GGCGGGGGCGG__GCGG
GGGG__GGCGG__GGCGGGGGCGG__GCGG
GGGG__GGCGG__GGCGGGGGCGG__GCGG
________C______C_____C_____C__
________C______C_____C_____C__
________C______C_____C_____C__
________C______C_____C_____C__
________C______C_____C_____C__
GGGG__GGCGG__GGCGGGGGCGG__GCGG
GGGG__GGCGG__GGCGGGGGCGG__GCGG
GGGG__GGCGG__GGCGGGGGCGG__GCGG
CCCC__CCCCC__CCCCCCCCCCC__CCCC
GGGG__GGCGG__GGCGGGGGCGG__GCGG
GGGG__GGCGG__GGCGGGGGCGG__GCGG
GGGG__GGCGG__GGCGGGGGCGG__GCGG
GGGG__GGCGG__GGCGGGGGCGG__GCGG
CCCC__CCCCC__CCCCCCCCCCC__CCCC
GGGG__GGCGG__GGCGGGGGCGG__GCGG
GGGG__GGCGG__GGCGGGGGCGG__GCGG
GGGG__GGCGG__GGCGGGGGCGG__GCGG
