10
_____R____
__________
____R_____
_________R
__________
_____RR___
_____R___R
__________
_RR__R____
__________
