50
__RRM_M______F__________R__M___M__M____R__M_RR_R_F
__W_M_MF_M_W__R____R__M__MM__M_____M__RMR__F___M__
R_R____R_M___M___F__R_R____M___FF____M___R_R_F_R__
____R__M_____MR___R______F____RR___M__M_M_____R___
RMR__RR_______RRF__R_R_M_F_____BR______R___M_____R
___FFRF___________R___WMFB_R_R_MF__F__R___________
MM______MM____M_____R_____M____R_____________R__R_
_____M_F________________MM____________MF_M________
_MRB________R_____F____M___R_____RM__M___M_R_R__R_
B___F_M____________R____R____M_________R___R__F_FM
________F__BM______R_F__________F________RM_____MF
_R____M_R_R____WW___RMM_FR_________________M_FM__F
__RM_____M_____FRR_M___F__B_M__B__M__RR_MMM_______
_B__R________F_M_F__R____WM_R______M_MF_____M_R___
___R___RR__F________BF__M_MF_F_______R____R___R___
R___R__MF__F_MM_____________M_F_______R_________B_
___WMMR__F_____FRW_______RF___F___M__F______MM_M__
_M_F____R_____M_________________RW__B____RR__R____
_____MRR___R___F__FRMM___F__R_M________RF__RM_RF__
_R______________RM__M_____R___________W_____F_____
____R__________F_____M__M__R___M__RR___W__W_MMR___
______R_____MR___FMFR________RF__RMMR_M__RR_____F_
___M__RR_____M__________RF_______RF_________RM____
_____R_____________R_______________F__FR_________R
_MBFW______________R___R__R___WRR_M__RB___M_______
___________RM_M___R___B_R__M_________R_____MMR_F_F
F__R__M_R____M__R__RFRM__________________R________
M_____F____M_F___________M_MW_______M__R_MR_M_F___
R_F_R____R___M___M_________M____R_________B_F____M
____M_F__M____R__RR______RM____R__M__M________MW_R
_____________RR_F___R____________F_____RRR_______M
_____R___F_M_______F_____MRR_______F__R__FR_RR_M__
________M_M___MR_________________R________________
M___FR_RRMF_F__R__M_M_____M_______R______RR_RR__R_
__R_F________MMWM____R_M______M___FR______MM_____R
_MF____M____R____FR____F____R__M_____R_______FR___
WRBBM___________R___R_______M_____F___M_F_________
____R____F_____R___RM_M__R_____RMF_____RFF_R_____R
W_MB__________R_______R_F__RR__FF_______RM_W_M__M_
___R_____FF_____WB__________FM_RR____________M__R_
____R__________FRMMR__M_____R_W____F__M_F___W_R___
__M__R_R____F____R____R___R___M__F______M______MRM
___R___________RR_M______R__M_______R_______M_R___
__F_________________M_R_________RM_F_____F___B__M_
M____R_____________RR____W___R_______R_R_M_______M
R_R_M____R__F__M______M________F_WM______F________
___F____F__F_____M__R____________F____RF_____FR___
_F____M_____RR_M_____M_________R__R__B__F______R__
___B_______B__M__B_________________MFM_______R_R__
RMBF_____R_RF__________FM_M__RM___M____F_R_R_____R
