10
__________
__R_R_R__R
_____R____
_____R____
____R_____
__________
________R_
______F___
_______R__
__R_______
