100
______F_F__R_R__RF______R_________________R____F______________R_______RR_R_____F___________RR_____R_
__R______R_R__________FR______R_____________F___________R_____RF__R________________________________R
_____R_______R_FRRR____R_______________________R____________RR________________________________R_____
F___________R_R_____R_R____R__R________R_________R__________________R_F_________R_R___________R_____
R_R____FF__________________________R________R_R______F___R___R________________RR__R__R___R__________
____________FR_____________R______R__R_____R_F_____F__FF________________R____R____________________R_
_R________R__R____R_______F_R________R__R______________R____R_______________R_________F___________F_
_______________R_____R__R_F________F__F_F___________________________F____________________F_____R____
______R__R________F___FF____RR___R__F______RRRR_________R__F_R_______R___R__________RF_____R__R____R
_____________R_F_F____________R_F_____________________________________F__R_______F__________________
_R_FF__________________________R__R_______R_R_F_F__________________RRR_R___R_______F__F_____________
_______________________F____RR_RF___R____FR__R_______F_F____F___RF__R________________F____________FR
___________RRF____________R_________________R_________R___________F_______F___R__F___F__F_F_________
______________________R__F____________________F____RF____F_______R_R_R_R______________________F_____
_F________R___________________F______R_F__________R____________________R____R____________R__R_______
F________R__F____FF_______________________________R_R_R_R_FR_______RR__RF___R_F______________F______
____________F_______________F_R_R_____R_______F___RR_F________________R___R__F_R_RR_R______F___R____
____F____________________________R_______FR___________R__R_____F____________________R____R______RRRR
_____________RR___R_________________RR____________R____F___F___________R___________________F_F____R_
_R___R__________________R__RF________________R__R_____R_____________R____FR____R____________________
_______F____F____________R____R____________R____R________FF_____R_________F__FR_______R__R_RR___R__R
________________R___R___R_________F__________R__RR______________F_R___R_______R__________F_______F__
______F______________R________R_RF__R_____R__F_R___RF_______F__________F____R_______________________
___FR___R___________________________R___R___FF_____F_____R_____R_R___FRR_R___RR_____R_____________R_
_R___R__R________R__F_______R______R__FR____R___F_R____________R________R_____R_R___________________
___________R__F______________R_______________R____________FR__________R_F_R______R_R__R_F_________R_
___F________________R______________RRR_F_______________F__________F______R__R___F__R________________
___FF__RR_R___R______________F_F_________R__R_R_____________RR__R____R_____________RR______R______R_
____R____R__________R____________R___________F____R____________R____R__F________F____R___R__F_______
___F_____________F_____R_R__________R____F___R_F___R_____F____________________R________FRR_R_R__F___
__R__R_____R___________F_R____F_FR___F________________________R______________R___R_________R_F____F_
_F___________________________________F___________RR_F____R___F_______________R_F______F_____RRR_____
_F_R__R__F______R_R___R__________R_______RRRRFF______R___R_______R____________R______R_________R____
______R__________R___________R___R__R____R________RRRR_R_R_________F______________R____F______R___F_
R___R________RR________FR___R___F_______F___R___F__R__F_______________________________________R____R
_R__________RF_______F______R__F___________R_F_______F_______R_________________F_R_____R___F_____R__
_______RRR_______________R_____________________R_________F___R________F_____R__R_R_R___R__________R_
________________F_______R_________R____________R___R______RF_____R_R_____________F______R_____R_____
________R_R_____F___F__________R_____F__R________________R_F_____F_FR___R__R_F_R_________RR___F_____
R____________R_____R_________RR_________F____R___F______R__F____R________RF______R__________________
_______RF___F___F________F____R____R_F__________________R_FR___________R___R____________________R___
_R___________R________F__________F__RR_____F__RRR___RF____R______F____R____________________RF__F__R_
_____________R__R____R_______RF____R___R_R____R_____________R__R_________RF____R_____________F___F__
___________________________F__________FR____R__R__R______F_______F_F______R________F___F____________
__R_F_________F______R___F_________F__F_F_R___F____F_R_________R_F___R____F______F_____F____________
_R_F__F_________R__________________R_R_R___F____FR______________F______R__R____R___________F_F______
_______R________R____________F__RR_R____R_R__________RF_____________________________________________
_R_F___RR___R_________R__________R__R_________R__F__R_R___R_____R_R____R____R___R____RF___________R_
_______________R_____R____F__R_F__________F__RR_F__R________F_______FR_F_F__R___________F_____R__R__
R__R_____________R_______________RR______F__F_F_R_____F_________________RF_______RR__F__________R__F
___F_RR__________R___R____R_____FR____________FR__RR__F_______________F_____RF_____F____R_____R_____
_R__F_RR___RR__R_______R_____R___________RF_______FR_RR_______F_RRF________R____R_____________FR____
____R___R_______R___R__________F_R_____R__F________________F_F______RR___________RF_______R_________
___RFF___RR___R______F______________F____________________R_____R_R_F_____F_F_____RFF_______RR_______
_____F___F_R_____F__R__R_R___FFR__R___R__F__R___F_F_____R__R_______R_________________R______R_____R_
_____F______________R_______RF_____F_R__F_R____F__F______R__R__R___R__________________R_F___________
_R________F__R___R__R_R_R_________R____R__F___R_____F_____________R__________R______RRF___R___F____R
__R____R___F______R_R___________________R__FR___________F_________________RFR_______________________
R____R____________F_R_R__R__________R________R________R_____F__________________F__________________R_
_______R_R____R____________________________F___R__R______R______F____________R________R____R______F_
__R______R____F___R_____R____F________________RF_RRFFR____RR_R_____RR___________R_F____R_______F____
_R__________R___FF_________________________F_______________R________FRF_____R___R__R______R_____R___
_______________________________R______________R______RR_______________________F_____RR______R_R_R__R
____R_______F_FF___________R_____F__R__________F____F_R__FR_R_________F______________R________F_____
_RF____R___F_______FR___F____________R___________R_____________________RF__F__________F__R__R____F__
R________R__F_R_____F_____R___RR____________RF________________________F_R_______________FF__________
________________________R_______________R___R______RR___R____R_____R______R_______RR__________R_____
________F____R_________________R_________________R________________F__F___F___________________F___F__
______________FR__R____R___R__F_________R__________R________R_______F______________________R___F____
___________________R____R____R_R____R____R_R______F___FFR_____F__R_________FF____F____F_____R____R__
______F_R__R__R___F_______RR__F__________R_F____F________________________FR_____R_____________R_R___
__F____________R_R_FR_________F_F__R______R___R_______F_F_R__F________R____________R___F___F________
__________RR___________________R_______F_____________R_____R____R______F____________________________
_R___R______F____R__RF___FR_______R_________________R_RR___R_________________R__F____R_______R______
__________R________R__R__F_______R____________R____________F__R___F_____________RR_____F_______F____
______RR_R___R_______R_______R___RR_R___R_______R__________F__________R___________R_________________
R___R__R___________FF____R____F____R__F____FR_R_____FF_____________F_R_______________F__________R___
_R_______________________RF_____________FF____R___________________________RR_____F_______________R__
__F_____________F_R_____________RR________R_R_________R______R_______________________________R______
__F_R__R_______R____F_________RR_RF______R________________R___________R____R____F______F____________
___F___R__R_________R____R___R_________________R________R_____________________R________F_R___R_F____
___F____R_R____FR_______F______________F_______R__F_______R__F_______R___R______F_________F_________
_R______RF_R____R____RR_________________R____R___R___RR_________R_RF_______________R________________
_______R__________RR__R_________R_RRRF___F_F____R__R___R____R____R____________F_R________RR__F_R____
___FF_________R______RF_____F________R____________FF_R___F_____R___R______F___F__________R__R____F__
____________________R____R__________RRR__FR__F______________R______R_______F_______________R______F_
_________RR_RF______F_____RR_____R___________R_________R________________________R_R_FR______________
R__RF________________FR______R________________R__________FR_______F____________________R__R_________
____________R__F_______RF_RRR_R_______R_______R__R___RR___R___R__F______________R___________________
___________________F_____________R__R__________R___R________R_R______F____R_R_____R________F________
________R_R_F___R_____R____________________R__________R________RF____________F______________F_R_____
___________R_F__F_________R_FF_________R________R__F________________F_F______RR_____________F_______
____R___R__R_______________R________R__F________R_FR______________________________________R_R____R_R
R_____R_____R___R__________R_R______________RR_____F____R_________________R_________R______R_R_R__R_
__________R__RR_____R___________RR_____FR__RR_R______R_____F_________R_F_________________R__________
RR_____R___FR__R____R___R_____F______R_____R_F_________F_____F___R__R____________F_R________________
_____RF____R_________F_R_R__F____RF____R___________R_________________R___R______________F_____F____R
_F_R_________________________________F__FR__F___R_R_______R______________R_R__R_______R_R___________
_R__________________R____________________________________R____F____R___________F___R___F_____R__R_R_
__________R_________F__F___R________F_F________RF___R______F____F______R_F______R____R_____________R
