100
G_GGGC_GCG_G_GGGC_G_GGCGGGCCC_GGGGGGCCGGCCCCGGG__GC_GGCCGGCGGC__GGCCG__GGGCCGGC_G_GCGG___G_G___GGG_G
GC_GGG_GGCGGGGCGC_GGGCG__G__GCG___CC__C_CG__GGGGGGGCC_CCGGGCG_GCCGG_CCCGGGC_GG_G_CGGCGG_G_CG_CGGGCG_
G_CGCC_G_CGGCGG_GC____CG____CGGCG___GGGGC_CGG_GCG_G__GG_CGCGC_CGGGC_CGG_G_CGG_CCG_GCCGGGCGG_GCG_G_C_
CGG__G__CGC__GG_G_CCGCG_CG_CGGCGCG_C_GCGCGCGGCCGCC_CGCG___CG_GGGG_GG_C_CG_C_GC_GGGCGG_GGGCGCGCGG_C_C
GCGGGG_CGGGGGGGCGCCCG__CGGGGG_GGGGG_GG_GGCC_GGG_GGGC___G___CCC_GGGCCG_GGCG__GGCGGCC_CGGGCG___CG_CG_G
GGCCGG_CG_GGG_CGGGG__C_GGGGGGC_C__GC__GG_GGCGGGGGC_G_C__GGGGG____C__CG_C_G_GGG_CG_GGGGGCGC_GCCGG__GG
_G_GG_C_CGGGC_GG_GG__GC_GCGGGGGG_GCGGG_G_G_GGGGG_G___CGGG_GG_GGG____G_CGG_GGGG_GC__G__C_GGGC__CC_G__
G_GGCGGCGG_G_CCC_GC_C_GGC_CCGGGCG_CGGGGG_G_CG_G_GG_G_GGGGCGGGC_G_G_GCGCCGGGGG_GGGGGGGGGCCGCGCC_C_GCG
GG_GGGGGG_G_GGGCGGGC_GGGCCCG_CGGGGC_CGGGCCG_GGCGGGGGGGGCGGGGGCGC_CG_G_CC_CGGCG_GGCGGC_G_GC_GCGGC_CG_
GGGCCCGGCGGG__G_GGGC_GCG_CGGGC_C___G_GGGCCGC_GGCGGGG_G__GGGG_G_GC_G__GCGGC_CGGC_GC_GGCGCCCGG_CG_GC_G
GGGCGGGGGGCGGGG_GCGG_G_GGCGCC__GGGG_CCGCCGCGGGG_CCGGG_GCC_CGGCG_CG_GC__GCCG_CCGCCGGCC_CG_GCG_G_GCCGG
GGGCGG_CGGC_CCG__GCCGCGGGGGGC__GCCC___GCG__GG_CGGC__GGGGCC_GGG_G__GCG_CCGGG__CGCCCG_GCC_GGGGCC__G_G_
GGGGG_GCCGG_GGGC_CGCCGCC_GGGG__CGC__GGGGGGC____G_GGGCG_GGGGCC_GCCCCGGG_G__G_GGCC_GG_CCG_GGCGC_GCCG_G
_C_GC_CCCGC_CGGGG_G___C_GGG__GG_GG_G_CGGC_GCGGG_G_CGGCG__CGG____GGCGCCCCGG_CGGGGCCGGG____GGGGGC__CGG
GGGGG_CGG___GG_G_CGGG_GCGGCCG__CGCGCCG_G_GCG_CG___GGGGC_C___GG_CGGGGG_GGC_C__CG_G_GGG__G__GG_GCGGGG_
C___C_GGGGCCGCG_G_GGCG__CGCGCCGGGGG_G__GCGGG__G___GGCC_G_CGGGGGGCGGGGCG_GGC_GGGGG_G_GGCCGGG_GGCGGG_G
GGGGGG__CCGGGGGGCG_C_GG_C_GCG_G_GG_CGCGCGCCG_CG__GGGCCGGCGCG_C_G_GC_GGGG__CG__GG_GC_G_GGCG____C_G__G
GGGGCG____GCG_GGGGGG_G_CGC_G_CGGGC_GC_GGCCGGG_GCGGCCGGGCCGCCGGGCCGGG_CCG___GGGGG_CGCG_GCGGG_CGGGGGCG
GG_CCGGG_CGGGGC_GGCCGGGCGG_GCGGGG_GGCG_GGCGGC_GGG__GCC_G_G_G_CGGC_C__GG_GG__GCGGGGGG_____G_CGC__GGGG
_C_GG__GCGGG___GG__GGGCGG__G__GCGCCC_G__C_CGCG_C_CGGGGCG_GGG_GGG_GC_CC_CGGGGGCGG_CGCGGCGGG_CCG_GGG_C
GC_CG_GGCC_GCGG_CCCCGCGCGCGCGGG_CG_G_GC__GGCGCG_GGG_CCG_G_GCGG_GC_C_GGGGGG_CGGGGGGGGCC_CG_G_GGG_G_GC
_CGC__CGC__GCC__GGGCCCGG_G_CGGGCGGCC__G_GGGGCGG_CGGGCGC___G__GC_CG_GG_CCG__GCGGGGGGC_G_G_GC___GGG___
__CCG_CC_GGCGC_C_CGG_CGGG_CGG__GC_GG_GGG_GC_GC_CGGGGG_G_CGC_C__CGG_CCGCGGC__CC_GCGCC_GCGGGG___GCC_GG
_GGGGGGGGGGGGGGCG_GCG__GC__CGGGGC____GGCC_GG_CG_CGGCGCGGGG_GCG_CCGCCGGGCGGCGGG_GCGGG_G_GGC_CGGGCCGGG
GG__G_GGCGGCCCC_CGGGCCGCGGGG_GG_G_GCGGG_GCGC_GGGCCC__GGG_C_GGC_CGGG_GG_GGGC_G_GGGGGG__CCGCC_GCG_GGCG
_GGCGG_GGG_GCGGCCGG_GGGGG__GCCGCGGC_GGCGCG_GGGC_GGGG_GGCGGGG___G_GGCGCG_GGGGGCCC_G__GGG_C_GG_GCC_GGG
GGGCG_C_CG_GGGGCGGG_GCG___GG_GC_GGGGG_GG_CCGC_CGGGGG_CCCGC_GC_G_GCG_CGGG_GGGG__CCGGGGCG_GCGGGGGCGGCG
_GG__GCCCGGG_GGG__GCG_C_C_GCG_GCGCGGGGGCCGC__GGGCCCGG__GGG_GGGGGGG_GCGCCC_G_G_GG_G_GGGGC_CCGGGGG_GGG
GCGGG_GCG_G__GCGCGGGC_CGCGC_GGCGG_GGGGG___GG_GGCGGC_GCGC_GGCC__G_GGGGG___GGCCGCCGGC_GGGCGGGGGC_CCG_C
G_G_G__CGCGGCGG_GCGG_CC_GCGGG__CGGCCGG__G___CGCG_CGGGGGGGGGGGCGGG__GCGGGC_CGCG_C___GCGCC_CGGCC_GGGG_
GGGGGGCG_CG__GCCCGG_C___C_G_GGC_GGC_C_CGCG_GG_GCG_CCGGGCCC__GGG_GGGCGG_GGGGG_GCCGCGGCGG__GCGGC_GGG_G
GCCCGC_G__GGGCCGGGG___GGG__GG_GC_GGGCC_GCCGGG_GGC__GGG___GGCC_CC_GGG_CGG_CG_GG___GCGGC_GCCGG_GGCG_GG
G_CGCC_GCGGCGCG_CC_GGGGCG_GC_C_GCGCCGGC_GCG_GGGCCGG_GGCCCG_CGGGC_GCGGGGGC_G_GGGCCGC_GGCGCGC_CGG_GGG_
GG___C_GGGCG_G__CGCGC__GG_GGGGGGGGG__CCCG_C_CGC_GG_G_GC_GCGCGGGG_GGCGG__GCGG_CG_G_CGGGCGG_GGGGGG__GG
GGGGGGCGCGGG_GG_GCCCCGGGCGCCCCC_GGCGCGGGGC_GCGGG_GCG_GGGGGC_C_CGCCG__C_GGGGCCG_G_GCCGGGCGGG_GCGGGGGC
_C_GG_CC_GGC_GCC_GCCCGG_G_GGGGCG_CGC__GCGGCGG______CGGC__GGGG_CGCGCGC_CGGGGG_CGG_GGGCGGGGG__GGCGG_CG
CGG_G_GCGGGG_GGGGGCGGCCGC_G_G_GGGG__CGGCGG_GCGGGCGGGC_GCCCCCC_GG_GGCGG__G_GG_C_C__GGGGCG_C__CG_CGGGG
GCGCCG__GGG_CC_GGGGCGGGCG_CCCGGCGGG___GGG_G_GG_G_GGCGGGGCCCGG_CC__GGGGCGG_GG_G__GGGCGGCGGGGGC_CGCGC_
G__GCGGGGG___GG_CC_GGCG_CGGGC___GG__GGGCGCGCG_G_G_CC_GGGGC_CGGC_G_GG_G_C_G_GGGCG__GGCGGGCG_GCG_GGCGG
G___GG_G_GCG_CGG_G_CGGCCG_C_G_GGGG_CGGGG___C_GGGCCC_CCCCG_CGCCGG_GGGG_GGGC__CC_GGG_G__G_G__GG__GGC_C
GGG_CCGCGGCG_GGG_CCG_CGC__CGG_GGGCG_G_GG_GG_GGC_GGCGGGGGCG_GGGGGG_G_GCGCCG__CGGC_GGGG_CGG_CC_CGC_G_G
_GGG_GCC__GGCGGGGG___G__GCGGC_GCGG_GCCCC___CGCGCGGG_G_GCCG_G___CGG__GG_GGGC__G_GGC_GGGGGG_GCCGC_GG__
GGGG_CGCCGCCGCCC_CGGGGC_GG_CGCCGGCGGCCGC__CGGCCGG__CG_G_CCCGCG_GGC_GGGGGGCCGGGCCGGGGCGGGCGGCCGCGGC_C
GCGG_GCG_CGGC_G_G_CGGC__GGGGGG_GCCGG_GCCGG_GGGGGG_GGG_GG_GGG_GGC_GGG_CC__GG__CGCGGGCCCGCGCGGGGCGGG_G
__GGGG_C_G__G__GGGCCG__G_GCCGG_G_C_G_GGGCGCCG_G__GGC_CCCGCGGG_GGCG__CGCCCGCG_G_GGCCGG_G__GG_GG_CCCGG
GCGCCC_CG_CGG_GCG_CGCG_____GGG__G_GGGCGCGG_G_GCCCG_GCG_C__GGGGGGCG_GGGGCGCGCGG_G_GGC_GGGG_GGGGGGCG__
GCG_CC_CCGGGG_CG___CG_C_GGGGGGC_GCCC_GGG_GC_CGGGCG_CCG___CCGCCCGCGG_GC_CG_CCGCC_GGGGGGGCCGGGGGG__GGG
__CCCG_CG__GCGC_GGGGGCCCG_CCG__GG___CGGGC_CGGGCGC__C_C__CGCGCC_GGCG_GG_G_CC___GG_CGGGC____G_CG_GG_GG
_GG_C_G_GG__CGGGGGCGGGC_GG_G_GGGGGGCGGG_GGGCGGGG___CC__GCCC__GGGCGC_CGGG_C_GGGGCCCCCGGCCG_CGG___GGGG
GGGGGGGGC_GC_GG__GGG___GG_G_GGGCCCCGC_CCCGC_GG__G_GG_CGCC__GC_GCCGCG_GGCGC_G_CCCCG_GGGGGGCCGGCCGGG_C
GGGGG__CGCC_G_CG_G_GG_CCGGGC_GGGGCCG_CCGG_GCCG_G_CGG___GG_CG_GCCGCGGGCC_CGCGGC_GGGGG_G__GGGGGCCGCC_G
G__CGG_GGG_G_CCC_C_GGGCGG_CGGCGGGCCCGGG__GCC__G____GG__GCGGG_G_GGGCGGGGGGG_CC_GGCG_GG_GGGGGCGGCGG_G_
G_CG_GGG__GGCGGG__CCCG_GGC_GCGGGC_CCGG_CGGGCGC_GGGGGGGC_GG__GC_GCGCGG_GGGGGCC__GGC_G_CCGGGGGGCCGGG_G
GG_G__G__GG_GGGGGGCG_GC_GCCCCCGGC_CG_CC__CGCCCGC_C_GCG_C_CCGCG___GGC_CGC_GGGCC_CG__GGCC__C__CG_CGGGG
GCG__GG_CG_GGCGCG_G__C_GGC_G___GGG_C__CGGCGCGGC___G_CCGGGGGGGCCG_G___GCCGGGGC_GCC__GCGC_CGGG_CGG__CG
G_GG_GC_GGCGCGGGCGG_CGG__CGGC__CGCG_G_GGGG_G_G_GGG__GGGCCGGC_CGGGCCG_C_G_G_G__G_CGGCGGCGGGCGCGCGG_GG
_GGC_G_GC___CGGGGCGCGC___CGGGGC_CCC_CG_GGCG_G___GC_G_CGGG_G_GCCGGCGGG___GGGCG___C_CG_C_GGCC_CGGCGCGG
GGGC_GGGGGG_GGGCGCCCGGG_C_G_GGGGC_GCG___CCGCCGGCGCG_GGG__GGCGCCGGCGCCGG_CGGG_CG_CCGGGCCG_GGG_GGGGG_G
CG_GGCG_GC__CCGCC_GCCG_GGGGGGGG__G_CGCC__GGCCC_GGGCC__GGGGGC_GGGGGG_C_C__G_G_GCCGCC_GGG_GGGGGGG_GGC_
GGG__CG___GG_CCGG_G_CCC__GG_GGGGCG_GC_G_GCG__GG_C_G_C_CG_GGG___GG_GGGGGGGGCG__G__CCCC__G__GGCG_CGGG_
___G_GGGGGGCGCG_GCG_GGCCGCGGCCGGCCGC___GC_G_GG_GCGGGCGCCGG_CC__GGGCG_GCGGGC_G_GG_GGCCCGC_GGCC_CGCCCG
CG_CCGGCGG_GCG_CGGGGGGGG_CGCGGCGGGG_GGCG_G_GGGG____G_GG_GG__CCG_GC_G_GG__C___GCGCCC_G_CCGG_GCCGGCGG_
GGCCG_GGG_C_GCCCCGGCGG_GG_GCC____G_GGG_G_CC_CGGCG_GG_CGCCCGGG_GCGG__GCGG_CG__GC_GG_GGCGG__GGGCGGGGG_
_C_GG__GCCGGGGG_CG_GG_GGGG_CGCCGCCCG_GG_GCG_G_C_GG_G_GCGC_CGGCGCCCGGC_GGGG_G_CG_G_C_CGGGGC___CCGGGCG
C_G_GC_GG__GGGGGCGCGC_CCC_GGGCGCGCG___GCGGCGCGGCGC_GGCGGGCG__GC_C_GGGGGC_G_GGCGCCGC__GC_G__GGGG___CC
CGG___CG_C_GGGGGGGGGGGGC_CGGCGCGG_GGC_CCGC_GGCG_G_GGC____GCGCCC___GCCGCCGC_GCGCCC__G__GG_G_GG_G_GGGC
_C_____GGG__GCC_G__GG_GG___GGCG_GG_GG_GC_GGCCC_GC_GCCCC_GGCGGG_G_G_GCGGGCC_GGCCGC_CCGGGC_G_GC_CC_GGC
GG__CG_C__CGGGGCG_GGCG_CCGCCC__G_GCGGC__G_GCG_GGGCGC_GCGGGGGCGCG___CGC_GCC__GG_G_GC_CG_CGGGGG_GCGGG_
_G_GCGC_C_CCCGG_GGGGG_G___C_GCG_C_GCG__G__GC___G__GCGCG___GG_GCGCC_GGC_G__G_C_GG__G_GG_GGG_GGGCGCGCC
G_CGGCCGG_CCG_CG_GGG_GGGGGC_GCGG__GG__CCCC_CGGG_CC___CGC_C_G_CCGGGGGCGG_GGCGCGGGGGGGCGGGCC_GG__CGC__
_CCGCCGCGCCCGG__CGCG_G_GCGGG_GCC_G_GG_CG__G___GG__GGGGGGCC_CGCGCGGGGGCGGG_GGGGGCCCG_GGGGGG_GCCCG__G_
CGGCGCCCCGGCCCGCCCGG_GG_CGGCGCCCCGCGGG__CC_C_GCGCG__G_____GGGCG_GGGGGCGGGGGGCGGCGGG_GGGG___CCG__CGC_
CGCG__GC_GG_CG__GG_GCGGGG_CC_C__CGGGGG__GGGGGGG_CC__GGGG_GG_CCCCGGG_C_CGC_CGCCG_G_G_CGGGGCGGGGG_G_GG
GCG_G_G__GGCGCGG_C_GCGCGG_GCGCGGGGGG_GGGCCGC__CGGGG_GG_CC_CGGGC_G_GGGGGCGGCGCGCGG_GGG_G_GG_G__C__CCC
GC_GGGGCGCGGC_CCCG_GCGGCG_GGGCCCGG_G_C_GGGCCG_GCGCGG_GGC_CGGGGGC_GC_G_CGC_GG_GGG_GGGGG_G_CGG_G___GCG
G_G_GGGGGGCC_GG_G_GGGG_GG_CCGCC__CCG_GC_CGG___GGG___GGGCCCGGGC_GGGG___GGCG_CG_G_G_GGCG__C_CCGGGCGGC_
GGGGG_GG_G_C_CG_GGC_GGCGGCG_C_GG_CCCGGC__GGC_GGG_G_CG_G__GGCG__G__G_GGG_GCGGGGGCGGGGCC_GCGCGC_GCGGCC
GGGCGC_C_GGGG_CGCCGCGGGC_GCCGGGGGCCC_CCGGGG_GG__GGCC_CGGCCGGGGG_GGG_CGG_C_GGGG_GGGG_G_GCGC__G__GGGGG
GC__CCGGGGGGGCG_GGGGGC_GCGC_C_GG_GCGCCG_CGGCCC__C_G_____CG__G_C_GGGCGGG__GGGCCGG_GGGGGGGGGCGGGGCGGGG
CCCGGCGC_CCGG_GG__GCGGCG_CGCCG_GCGCGGGCCGGGCGCCGC_GGGCGGCG_GCGGC_GGCC_GGG_C_GG____GG_GCCCGGC_GCGCCCG
_GG_CG_G_GCCGCGCC_GGCG_GCG_GG_G_GGGGG__C__CCGGGG___GCGCCG_GCCGGGG__GGC___CCCGGGGCGGC__CCGCGGGGG_CGCC
GGGGGGG__GGG_CGGG_CG_G_GGGGGC_CG_GG_GGG_GGCCCGGGGGCCGG_C_GG_GCG_CCCGG_G_CGGC_C_GGCGCGC_C_G__CCCGG_GG
GGG_CGCGG__CGGGGCCGGGCGC_G_GGGG__GG_CGGCGGG_CC_GC_GCGCCGGC_C_GCC_G____G__CC_GGGCGGCC_GGCGC_G_GGGG_CG
_GGGGG_GCCGGGGGG_GGCGGC_GGG_CGCCG_CGGG_CCG_CGG_GGGG_CGGCGCGC_GG_GCGGGGGG_GCCGGCCCG_C_CGC_C_GCGG__G_G
GGG_CCGG_GCG_GCGGC___GGG_G__G__CGGG_G__CG_CC____GCCGCGCG_GCCGGG_CGGGGGGGCGGG__GC_GG_CGG__GG_CCGG_G_G
CG_GC_GCG_C_G_G_CGG_GC_GCG_CCCGG_GGGGCGGGGC_CCCGC_G__GGGCGCGCGGGGG__GGC_CG_GGC_G__GGC__GCGG__GGCGCCC
C_GG__C_CGGC_C_GGC_CG_GCG_GCCG_CG__GGCG_GGC_G__CGGGG_GGGGGC__GG_GG_GGG_GC__CCC_CGCGG__CCGCGCGG__CGCG
___CGGGC_GGG__GCG__GCGG_G_C_CCGCGGGGG__CGCCGGG_GGCGGGCCCG_GCG_C_CCGCGG_C_CCGGGCGG__GGCGG_G_CGGG_G_GG
CG_CCG_GGGCGGG___GGG__CCGCG_GGGGG_G_CCCGC_GGGGCGG_GCCCCC_GGC__C_GG_GG__GG_GGGC_G_GC_CGGGGGCGGCGG__GG
GCGG_GGC_GGCGC__GG__CCCCG_CCCG_G__GGCGGCGGGCGGCG_GGCC_G_C_GGGGGG_CG_CGGCGCGGGGGCG_G_GGGG_GGG_CGCGGC_
GCGGCGG___GGCGC_GCCGGCGG_GGGGGCGCCGGCCGGGC__GGCGGGCCCGGGCG_CGGCGCG__C__GGGC__G__CCG_C_GGGC__G__CGCC_
CG_G__C__GGG_G__G_CGC_GCGC_CGG_GGC_GC_G_CGG_CCCGG_GGCGGGGGG_G_CGCCCG___GGGG_G_GGGCGGCGGGCGGGGC_CGC_C
GGCCGCGG__GG_GGG_CCCGCCGCCCGCGG__CG___GG_GGCGCGCGGGCC_GGGGCG__CG__GGG____G_GG_GGGGGCG__CCGG_GG_GG_GG
C_CG_CCGCCGG_G__GGG_GGGGG_GCG_GG__CCGGG_GG_C_C_GCGCGGGCCGC_GCGGC_C__CG_GGCCGCGCGC_C_G_GCGGC__CGGC_GC
_GG_GG__CCG_GGGG_G_GCCCGCGGCCCCC__G_GCGGGGGG__GCG_G_G_C___G__C_GC_CCGCG_GGGGC_GG_CCGGGGG__CGGC_G__GG
GG_CCGGGGGGCGG_GGGCCCGGGGGCCGG_GCCC__G_GCGGGCGGCGC_GCG_G_CGCG_CCGGGGCGGG__CGGG_C_GG__CG__GCCGG_C_CCC
GGGG_GCCGGG_GGG_G_CGGGC__GC_GG_GGG_GGG__GG_GGCG__CCG__GG_G_CCGGG_GGG_GGGGGG_GG__CGCG_G_GCGGCGGC_G_C_
_C_GGGG_GG_GG_CC_CCG_GG__GC_GGG_C_GGCGGGGCGG_GGG_G__GGCCCGGGGGGC_GGCC_G_CGCGG___CGCC__G_GGGC_G_____G
CCCGGG_GCCGGGCG_G_CG_GGCCCGGG_CGC_GCGGGGC_GCGGG_C_CCCCGGCG_GGG_GGG__GCGC____GGCGG__G_G_GGGGGG____CCC
_G_GC__GCGCGGGGGG_GCGGGG_GGGGGGCG_G_CC_G_CGCGGG_GCGGGGGCGC_GGCCGCGGGCCGG_CC_CGGGC_GGGG_GC_GC_GGG_CGC
