16
________R_______
___________R____
____R_F_____R___
________________
___R__R_________
________________
____________R___
__RR__________F_
____________R___
______R____R____
_____________RR_
R____________R__
___R_____R______
R__R___R_____R__
______________R_
__R____R________
