15
_______________
__MM______MM___
_____MM___MM___
_______________
_______________
___F___________
__________M____
_______________
_______________
____________M__
____M_M_M___M__
______M________
_______________
_________MM____
_______________
