15
GGGGGGGGGGGBGGG
GCGGGGGBGGGGGGG
GGGGLGGGGGGGGGG
GCGGGGGGGGLGGGG
GGGGGGGBGGBGGBG
GGGGGGGGGGGGGGG
GGGLGGGGGGGBGGG
GGGGBGGGLGGGGBG
GGGGGGGGGGGGGGG
GGGCGGBGGGLGGGG
GGGLCGGGGGGGGGG
GGGCGGGGGGLGGGG
BGGGGGGGGGGGGBG
GGGBGGGLGGGGGGG
GGGGGGGGGGGGGGG
