75
________F______R_R___B____MM_____MRR____RM______M_______M__________________
____R________R_____M___R____R______R_M___M_______________________R__RRM____
______R__BR__M__R_____M_______________M_______R___MM___F_______M_F_________
____R___M_____R_____B___M_RR__RM_____R_______R_R___R_R________R_______RM___
_FM_________R__________B_MF____F____M_R___R__M_F__R_____F__R_M____R___R____
________F_____M________WM_______R_R___RF_R_R____________RWFF____________M_B
__F__M__M___M___FFF______________WF_R_______R__R__R________R__M___F___M____
_________R________WR___MFB__RR_________R_M______W_____R_______B_______MR___
__________R_____R____M_____R___M___R_R____R_R_R___________RM__RWR__R_______
___R_____M____W__RF___________RR_______RR__R____R__R___R_______________M___
_M________M________________B______________R__M________R____M___R___R_______
__________M____MR___________________F____R_________R________R_______R____W_
_W__F______R__R_R_______R______M________________________R______R_R_________
______MRR_MM_______W___F___F_____B_M_RR___________R___FM_W____B____________
__R_R_________M_____R____M__________R______R__________R____RF_R_____MR_____
R___RR__________________RR__M______R_B_______RR_____________FR_R____RM_____
__M_____________R__R_M____R__M__BM_R__R_________MF__RM____M_______R____RR__
R__M_M_____M_R________________R______M__RM____M_______R__R____M___F__R_B___
_R_______M_______________________RR_______RM_____R__________________M______
__R_R_R____R___M___________________M_______R____M______RM________RR___R____
___W_____RM____RR______R_M__R_M_M____________RF________R___RR_W____________
___R___M____F_R_F______R_____________M_F____M____R___M________R_R__R____R__
___R_______R__________________RRR_______________________R____________RM____
____R_______R___M__R________R_____R____________R____W_B_____F__R__MR___MRR_
__MF__F_R______R___R___R___F____RM________R________________R____________R__
__B______M___F____R_________________F_R_______R__M__R_____M_____R_BRR______
__B_______M______________RMRM______MW__R________M_RR____________________R__
_W____M_______MR_RWM_R__RR_M_F________R_______R_____RM__R________FMM_______
R_M__________MR_R__F_____R__M______R__R_R_____M_______R__B___R_____________
_____R_R_R______M_____________RMR_B_MM_______M______R____RF__M_R_F_M___R___
__RRMR_FR_________M_W____R___M____R___________R_R_______R__RRF__M_R________
_R_____M__R__M___MM__R_R_R___M___M____M_________R_M_____R_______R_R_______R
______M_RF_____R_F_________M____________MR___RR______W___________________R_
__W_R_______M_FFB_____F___R_______W____M__________F________________MR____M_
________R_________________M___RF_________W_R____WRMR_BB_M____B_____________
___________F_____FR_____F____M_______F_R_______________MF_____M__F____R____
_M__R___R_____RM____M_____MMM__M______R_______RWM___R_____R_R__RRR_________
_RR________R____R________MM______RR__R__R_________M__R_____________F_______
____________________R_____F_RM_____________R___R____R_________B_B_______R_M
______BR_RM__________MMRR_R_________MR_______________B____R________________
_W____B_______________F_______R____________R_M___R_________MR______M____R__
___R___M_R________MR___W__________________R____________M______RB__________F
___R____F____M_R__B_____R_M_______M_________F_B_____R_R_____RM________F____
_______M___F_________W_R_______MF_____RW________RRR__R__________________RR_
_R_____M____________________B_M___W___R______________R_R_____FM_R__R___R___
F_R__R__M_R__________W____M________________R_MBMR__MR__________M__W________
_____M________RR_________R__________M_R____________________________W__R____
_____R_____F__R_____B______RRRF__R___M______W___R_____R_____R___R___R__M___
_______________RF_R__M_R__B____FR_BR____R_B___MM_______B_____M_R_F___M_____
_____M___________M____________R_M_______R___F___F__W___________________R___
_____R__R____R____R________RR_____RMF_____W___R_____________M_M____________
_______R______R_____RF___R______RRRM__R______R_B__M_______RW_R__M____R____F
_____________F_M_____FRR____B_R__M________M__M_M_______RW___R__R__________M
_R_______WM___RM__________M______________M___M____RM________R_R____RM______
__B____R____B_R___________________F______________B___M___R______R__________
________M________R_____FR__________R__R________R__M_M_______RR________W__R_
F_RM____R__R_R__F____M__R________R_________R_________R_______R_MFR____F_W__
__M____R____RM________R__R_R__________MR______R___________________________R
_W_R__R________________F____R____R____________RM___R___R_____F_______R_F__R
__M__R___RR_R___R_M________RR___M________R_RRM___M___W___R____RR_______R_B_
_______M_F___M____R_____R___RM_FR______M_RM__RR_______M____R_____R_MM______
_________RR___M____R_WRM_R_______RR__R___FRR________M_R______RR_R___B__F___
W________R___RRB___M_W_W_M____R___F__R___________R____R_____M_____F____M___
_____R______F______RM_R_____F____R____RM___BM____________FFRRR___B____R___B
___R_____R__M__F___W___RR_____F_______B__FR_______M_R__MR_B__R_R_______R___
R____R__R_______M______R_M__F__M_______R______R_M_____________M______MM____
____W____________R_R______RRR___M____M______R_____R__________R_R___R____R__
M_F__________M________________M___BR_R_M____________M_________W_R_________R
_______________M_______R_____R___________M___B_R_____R______R___R__B_M___R_
R________R___R__F________M_RR_______R__________________MB__________________
__R____W__F_____________M______R__________R___M_____RW__F_R______R___B_____
____________________R_R_________R__R___R______M_______M_________M___R__W__F
________M_RR_R_______R______R_____________________________R_____FM_____M___
R___________________MW_____R__________R___________WMW_________R_M_W____R___
__R_F______________MR_________________R__R___________R_____R______R________
