10
__R__RR__R
______R___
_R________
__________
_F__F_R___
_______F__
____F_____
_____R_R__
__R_______
F_________
