10
CGCCGGCC_C
_G_G_G_CCG
GCGGG___G_
GGC_CGGGGC
G_GC__GGCG
_GGGGG__C_
_CGCGGGGC_
G_GCGG_CC_
CGGCGCCG_G
__GGGGGGGG
