25
GGGGGGGGGGGGGGGGGGGGGGGGG
GGGGGCGGGGGGGGGGGGGGGGGGG
GGGGGGGGGGGGLGGGGLGGGGGGG
GGGGLGGGGGGGGGGGGGGGGGGGG
GGGGGGGGGGGGGGGGGGGGGGGGG
GGGGGGGCCCCCGGGGGGGGLGGGG
GGGGGGGCCCCCGGGGGGGGGGGGG
GGGLGGGCCCCCGGGGGGGGGGGGG
GGGGGGGGGGGGGGGGGLGGGGGGG
GGGGGGGGGGGGGGGGGGGGGGGGG
GGGGGLGGGGGGLGGGGGGGGGGG_
GGGGGGGGGGGGGGGGGGGGGG___
GGGGGGGGCGGGGGGCGGGGG____
GGGGGGGGGGGGGGGGGGGG_____
GGGGGCGGGGCGGGGGGG_______
GGGGGGGGGGGGGGGG_______GG
GGGGGGGGGGG________GGGGGG
GGGG___________GGGGGGGGGG
_________GGGGGGCGGGGGGGGG
GGGGGGGGGGGGGGGGGGGLGGGGG
GGGGGGGGGGGGGLGGGGGGGGGGG
GGGGGGCGGGGGGGGCGGGGGGGGG
GGGGGGGGGGGGGGGGGLGGGGGGG
GGGGGGGGGGGCGGGGGGGGGGGGG
GGGGGGGGGGGGGGGGGGGGGGGGG