15
_______________
_____RRRRRRR___
_____RRRRRRR___
_______________
_______________
_______________
_______________
_______________
_______________
_______________
____FF_________
____FF_________
_______________
_______________
_______________
