15
_______________
_____CCCCCC____
_____CCCCCC____
_____CCCCCC____
_____LLLLLL____
_______________
_______________
_______________
GGGGGGGGGGGGGGG
GGGGGGGGGGGGGGG
GGGGGGGGGGGGGGG
GGGGGGGGGGGGGGG
GGGGGGGGGGGGGGG
GGGGGGGGGGGGGGG
GGGGGGGGGGGGGGG
