15
______R________
___R___RR___R__
_____RR_____R__
_______________
_____R_________
___R__________R
_______________
__F____________
_______________
R_______R__R___
________R__F_R_
R___R_______R__
R______________
___________R___
_______R_______
