15
_GCLG__CC_G_C__
_____C___CL_G__
_L_G_G_CC__L_G_
__L_G_G____GGGG
_G_GL__LL____G_
GL__C___GG_GG__
L_____L_CG____G
_C__GLG______G_
_G_LL__G_G_G__G
GC__L__GL_GGLG_
_C_CC___GGGCGGG
______GGL_L___G
G_GCL_C__CLGG__
_G______GC____L
___GCC_G_GGG___
